##$ wil = 50; recVal = 0.9

##@ 국사
러일전쟁: 삼국간섭 이후 일본과 러시아의 대립으로 인해 발생한 전쟁; 이 전쟁에서 대한 제국은 중립을 선언했으나 무시 당하고 군사적 요충지를 장악당하고 내정 간섭 당했다; 이 전쟁에서 일본이 승리하여 포츠머스 조약을 체결하였다
포츠머스조약: 이 조약으로 일본은 한반도에 대한 우월적 지위를 승인받았다.; 러일 전쟁에서 일본이 승리하고 체결한 조약이다.
을사조약; 을사늑약: 일본은 황제와 대신을 위협하여 이 조약을 체결하였다.; 이 조약으로 대한 제국의 외교권이 박탈되고 통감이 내정 전반을 간섭하였다.; 이 조약이 체결되고 황성신문은 시일야방성대곡을 게제하였다.
을사조약; 을사늑약: 이 조약의 부당성을 알리고 무효화하기 위해 고종은 헤이그 만국 평화 회의에 특사를 파견하였다.; 이 조약 체결 이후 조약 파기 상소, 민영환 자결, 상인과 학생의 저항이 발생하였다.
시일야방성대곡: 을사조약이 체결되고 황성신문이 게제한 글.
나인형; 나철 | 오기호: 을사조약 체결 이후 오적암살단(자신회)를 조직한 사람들 (2명)
자신회; 오적암살단: 나인형, 오기호 등이 조직한 조직.
이재명: 이완용을 사살하려고 시도했던 사람.
전명운 | 장인환: 스티븐스를 사살한 사람들 (2명)
안중근: 이토 히로부미를 사살한 사람.
헤이그특사: 고종이 을사조약을 무효화하려고 파견한 특사; 이것을 파견한 것을 구실로 고종은 강제 퇴위 당했다.
헤이그: 고종은 을사조약의 부당함을 알리기 위해 ○○○ 만국 평화 회의에 특사를 파견하였다.
한.일신협약; 한일신협약; 정미7조약: 1907년에 체결된 이 조약으로 일본이 내정을 장악하고 군대가 해산되었다.
일진회: 한.일 병합 청원서를 제출한 단체.; 송병준, 이용구가 중심되어 조직한 단체이며 병합 여론을 조성한 대표적 친일 단체.
### 독도 개항 이후 침탈 심화 -> 고종, 울릉도 군으로 승격하여 독도까지 관할 -> 러일 전쟁때 일본이 강제 편입
간도 관리사: 19세기 말 간도로 이주하는 사람이 늘며 청과 영토 분쟁이 발생하자 대한 제국이 간도에 파견한 것.
간도협약: 일본이 남만주 철도 부설권과 탄광 개발권을 얻는 조건으로 간도를 청의 영토로 인정한 협약(1909)

을미의병: 양반 유생층이 주도하였으며 단발령 철회와 고종의 해산 권고로 활동을 중단한 의병.
을사의병: 을사조약을 전후하여 일어난 의병.; 전직 관리 민종식, 양반 유생 최익현 등이 조직하였으며 평민 의병장 신돌석도 등장한 의병.
정미의병: 군대 해산과 고종 강제 퇴위로 확산된 의병.; 해산 군인들의 합류로 조직력과 전투력이 강화된 의병.
서울 진공 작전: 유생 의병장을 중심으로 13도 창의군을 결성하고 서울로 진격하여 일본군 격퇴하려고 했던 작전.; 이 작전이 실패하고 소규모로 항전을 지속하다 일본의 탄압으로 만주.연해주로 이동하여 독립군으로 활동하였다.
애국 계몽 운동: 을사조약을 전후해 일부 관료, 지식인들이 전개한 실력 양성을 통한 국권 회복과 교육, 산업의 진흥을 강조한 운동.
보안회: 일본의 황무지 개간권 요구를 철회한 애국 계몽 운동 단체. 
헌정연구회: 입헌 정치 체제 수립을 목표로 한 애국 계몽 운동 단체.
대한자강회: 헌정 연구회를 계승하고 민중 계몽을 목표로 한 애국 계몽 운동 단체; 고종 강제 퇴위 반대 운동을 전개하다가 일본에 의해 강제 해산당한 애국 계몽 운동 단체.
신민회: 통감부의 탄압을 피해 안창호, 양기탁 등이 조직한 비밀 단체.; 국권 회복과 공화정 수립을 목표로한 비밀 단체이며 105인 사건으로 해체되었다.

오산학교| 대성학교: 신민회가 민족 교육을 위해 설립한 학교 (2개)
자기회사 | 태극서관: 신민회가 민족 기업 육성을 위해 설립한 기업 (2개)
삼원보; 만주삼원보: 신민회가 독립운동 기지를 건설한 위치.
신흥강습소: 신민회가 독립군 양성을 위해 만든 곳.
국채보상운동: 일본의 차관 강요로 대한 제국의 채무가 증가하자 국민의 힘으로 일본에 진 빚을 갚고 국권을 지키자는 운동.; 대구에서 시작되어 애국 계몽 단체와 언론 기관의 참여로 전국적으로 확산된 운동. ### 통감부! -> 실패

기기창: 신식 무기 제조를 위해 설립한 근대 시설.
박문국: 인쇄 업무를 위해 설립한 근대 시설.
전환국: 화폐 발행을 위해 설립한 근대 시설.
우정총국: 우편 업무를 위해 설립한 근대 시설.
경인선: 가장 먼저 개통된 철도.
경인선 | 경부선 | 경의선: 대한 제국에 개통된 철도. (3개)
광혜원: 의료 목적으로 설립한 근대 시설.
### 한성 전기 회사 및 가로등
### 생활 모습
독립문 | 명동 성당 | 덕수궁 석조전: 대표적인 서양식 건축물.
겸상: 한자리에 둘러 앉아 식사를 하는 서양식 식사 문화.
### 전통 문화와 갈등 있기도.
신분제; 신분제도: 갑신정변과 동학 농민 운동에서 계속 폐지를 요구하던 제도로 갑오개혁에서 폐지된 제도.
자유 민권 사상: 독립 협회의 활동으로 보급된 사상.
근대적 민권 의식; 근대 민권 의식: 애국 계몽 운동으로 이러한 의식이 고취되었다.
원산학사: 함경도 덕원에서 산수, 기기, 농업을 교육한 학교.; 우리나라 최초의 근대적 사립 학교.
육영공원: 영어를 비롯한 서양 학문을 교육한 학교.
이화학당 | 배재학당: 개신교 선교사들이 설립한 학교 (2개)
교육입국 조서: 갑오개혁 때 이것이 반포돼 근대 교육의 토대가 마련되고 많은 관립 학교가 설립되었다.
한성순보: 최초의 신문이며 개화정책을 홍보한 신문
독립신문: 한글과 영문으로 된 신문
제국신문: 한글로 되있어 서민층과 부녀자를 대상으로한 신문
황성신문: 국한문 혼용하여 양반 유생층을 대상으로한 신문
대한매일신보: 영국인 베델이 발행인으로 참여하여 일제에 비판적이며 국채 보상 운동을 적극 홍보한 신문.
### 국한문 혼용체
국문 연구소: 국한문 혼용체가 보급되고 우리말 표기가 늘자 정부가 우리말 표기법을 통일하기 위해 설립한 것.
주시경 | 지석영: 우리 말과 글 연구에 앞장선 대표적인 사람들. (2명)
을지문덕전 | 이순신전: 교과서에 나온 위인전기 2개. (2개)
미국 독립사 | 월남 망국사: 교과서에 나온 외국의 흥망에 관한 책 2개. (2개)
독사신론: 신채호가 지었으며 근대 민족주의 역사학의 토대를 마련한 책.
신채호: "독사신론"을 지어 근대 민족주의 역사학의 토대를 마련한 사람.
박은식: 여러 논술을 통해 민족정신을 강조한 사람.
혈의 누; 금수회의록: 교과서에 나온 신소설 2개. (2개)
해에게서 소년에게: 교과서에 나온 신체시.
창가: 서양식 악곡에 우리말 가사를 붙여 부르는 것이며 근대화 시기때 유행했다.
원각사: 연극 공연을 위한 우리나라 최초의 서양식 극장으로 신소설을 각색한 연극이 공연되었다.
천주교; 개신교: 학교, 병원, 고아원 운영 등의 사회 사업을 전개한 종교 (하나만)
천도교: 손병희가 동학에서 바꾼 이름.
나인영; 나철 | 오기호: 단군교(대종교)를 창시한 대표적인 사람. (2명)
단군교; 대종교: 간도와 연해주 등지에서 독립운동을 주도한 인사들에게 큰 영향을 미친 종교.; 나인영(나철), 오기호 등이 창시한 종교.
박은식: 진취적이고 실천적인 유교 정신 회복을 주장한 사람.
한용운: 불교의 자주성 회복과 혁신을 주장한 사람.

무단 통치: 일제가 헌병 경찰을 앞세워 한 통치 방식.
조선총독부: 식민 통치 최고 기구.
조선총독: 일본의 육.해군 대장 출신이 임명되며 입법.사법.행정.군사 등의 모든 권한을 소유한 직책.
헌병 경찰; 헌병 경찰제: 무단 통치 시기 의병, 독립운동가 색출, 일반 행정 사무를 하고 즉결 처분권을 가진 것.
토지조사사업: 지세의 공정한 부과와 토지 소유 관계의 근대적 정리를 명분으로 하였지만 실상은 식민 통치에 필요한 기초 자료, 재정 확보를 목적으로 한 사업; 토지 소유자가 직접 신고한 토지만 소유지로 인정하여 신고하지 않은 토지, 황실, 관청의 소유지, 마을 공유지, 문중 토지 등이 모두 조선 총독부 소유가 되었다.
토지조사사업: 이 사업으로 얻은 토지는 동양 척식 주식회사나 일본인에게 싸게 팔았다; 이 사업에서 지주의 소유권만 인정하고 농민들의 관습상 경작권을 무시하여 농민의 지위가 하락하였다.
동양 척식 주식회사: 1908년 우리나라 토지를 약탈, 일본인의 한국 이민을 뒷받침하기 위해 세운 회사.
일본어: 무단 통치 때 이 언어를 중심으로 교과목을 편성하였다.
회사령: 회사를 설립할 때 조선 총독의 허가를 받도록 규정하는 것; 이 것으로 한국인의 기업 설립이 억제되었다.
대한 광복회 | 독립 의군부: 국내에 남아 있던 민족 운동가들이 조직한 비밀 결사. (2개)
경학사: 만주 삼원보에 거점을 마련한 신민회가 만든 자치 기관.
신흥 무관 학교: 신민회가 운영한 독립군 양성 시설로 신흥 강습소에서 바뀐 이름.
서전서숙 | 명동 학교: 북간도에 설립된 민족 교육 기관 (2개)
### 중광단.
대한 광복군 정부: 블라디보스토크 신한촌에서 무장 독립 투쟁 준비를 한 것.
대한인 국민회: 미주 지역에서 항일 운동을 전개한 단체.
민족 자결 주의: 1919년 파리 강화 회의에서 미국의 윌슨 대통령이 주창한 것.
김규식: 신한청년당이 독립 의지를 알리기 위해 파리 강화 회의에 파견한 사람.
28독립선언; 2.8독립선언: 일본 도쿄 유학생들이 독립 선언서를 발표한 사건.
31운동; 3.1운동: 천도교, 기독교, 불교 등 종교계 인사들을 중심으로 한 민족 대표들이 계획한 사건.; 민족 대표들은 태화관에서 독립 선언식을 가졌지만 학생과 시민은 탑골 공원에서 독립 선언서를 낭독하며 시작한 사건.; 고종의 국장에 참석하기 위해 온 사람들의 참여로 서울 전역으로 확산된 운동으로 전 민족적 전국적 운동으로 발전한 사건.
31운동; 3.1운동: 일제의 지배 방식을 문화 통치로 바꾸게 한 결정적 사건.; 대한민국 임시 정부 수립의 계기가 된 사건.; 중국의 5.4 운동 등 다른 나라에 까지 영향을 준 사건.; 모든 계층이 참여한 민족 최대 규모의 독립운동.

제암리: 3.1운동 때 일제는 헌병 경찰, 군대 등은 시위대를 무자비하게 진압하였다. 특히 ○○○같은 곳에서는 주민들이 잔인하게 학살되었다.
대한국민의회: 블라디보스토크의 임시 정부
상하이 임시 정부: 중국 상하이에 수립된 임시정부. (2019. 4.)
한성 정부: 국내에서 13도 대표가 모여 이 정부의 수립안을 발표하였다.
대한민국임시정부: 그 당시 있던 임시정부들을 하나로 통합하기 위한 논의가 일어난 다음 수립된 상하이에 위치한 임시 정부.; 대한민국 최초의 민주 공화제 정부
이승만: 대한민국 임시 정부의 대통령.
이동휘: 대한민국 임시 정부의 국무총리.
임시 의정원; 의정원 | 국무원; 임시 국무원 | 법원; 임시 법원 : 대한민국의 입법, 행정, 사법을 담당한 기관을 순서대로 쓰시오 (3개)
연통제: 대한민국 임시 정부의 문서와 명령을 전달, 군자금 조달 및 정보 보고 등을 담당한 비밀 행정 조직.
교통국: 국내외 정보를 수집, 분석, 교환, 연락 업무를 담당한 통신 기관.
독립신문: 대한민국 임시 정부가 간행하여 국내외 동포들에게 독립운동 소식을 전한 신문.
독립 공채: 대한민국 임시는 이것을 발행하여 독립운동 모금 활동을 전개하였다.
### 의연금
구미의원부: 대한민국 임시 정부가 미국에 설치하여 외교 활동을 전개한 것.
문화 통치; 민족 분열 통치: 1910년대와 달리 헌병 경찰제를 보통 경찰제로 바꾼 통치 방식; 총독에 문관도 임명될 수 있도록 한 통치 방식; 언론, 출판 집회, 결사의 자유를 부분적으로 허용한 통치 방식
산미 증식 계획: 일제의 식량 부족 문제를 해결하기 위해 우리나라에서 실시한 것.; 일제가 우리나라에서 수리 시설을 확충하고 종자를 개량하여 쌀 생산을 늘린 계획; 이 계획으로 우리나라의 쌀 생산량이 늘어났지만 늘어난 양보다 더 많이 일본으로 가져가 식량 사정은 더 나빠졌다.; 이 계획으로 식량 사정이 나빠지자 만주에서 잡곡들을 들여왔지만 역부족이었다.; 이 계획으로 농민들은 화전민이 되거나, 만주, 연해주 등으로 이주하였다.
회사령: 1920년 이것을 폐지하고 신고제로 바꾸었다.; 이것을 폐지하고 한국인의 기업 설립이 증가하였으나, 일본인 자본가가 산업을 장악해 우리나라는 일본의 상품 시장으로 전락하였다.
실력 양성 운동: 민족주의 계열의 일부 지식인들은 실력을 키워 독립을 준비하자는 이 운동을 전개하였다.
물산 장려 운동: 1920년대 초 민족의 산업을 발전 시켜 경제적 자립을 이루려 한 운동.; 평양에서 시작된 '내 살림 내 것으로', '조선 사람 조선 것' 등의 구호를 앞세워 토산품 애용을 강조한 운동. ### 일제 방해 및 사회주의 계의 반발로 실패
민립대학설립운동: 일제의 식민지 교육에 맞서 우리 민족 힘으로 고등 교육 기관을 설립하려는 운동.; 대학 설립을 위한 '한민족 1,000만이 한 사람 1원씩'이라는 구호로 전개된 전국적인 모금 운동.; 일제의 탄압과 전국적인 수해, 가뭄 등으로 실패하고 회유책으로 경성 제국 대학을 설립하였다.
암태도 소작 쟁의: 소작인들이 추수 거부, 소작료 납부 거부 등의 방법으로 맞서 소작료를 인하하는 성과를 거둔 사건.
원산: 1929년 ○○ 노동자들이 일으킨 파업은 4개월 동안 지속되었으나 일제의 탄압으로 실패하였다.
방정환: '어린이'라는 호칭을 만들고 '어린이날'을 제정하는 등의 소년 운동을 전개한 사람.; 어린아이들을 하나의 인격체로 바라보고 소중히 여길 것을 주장한 천도교 사람. ### 천도교인
형평운동: 백정에 대한 사회적 편견과 차별에 반발, 백정들이 평등한 대우를 요구하며 전개한 운동; 이 사회 운동은 이후 다른 사회 운동 단체와 연합하여 항일 민족 운동으로 발전하였다.
농민 운동; 소작 쟁의 | 노동 운동; 노동 쟁의 | 소년 운동 | 형평 운동: 교과서 및 학습지에 나온 4가지 사회 운동. (4개)
6.10만세 운동; 610만세운동: 순종의 국장일에 격문을 뿌리고 전개한 만세 시위. ### 확산 안됨
광주학생항일운동: 한.일 학생 간의 충돌이 발생하고 경찰이 편파적 대처를 하자 광주 학생들이 민족 차별 중지, 식민지 교육 철폐, 일제 타도 등을 주장하여 전개한 대규모 시위.; 3.1 운동 이후 최대 규모의 항일 민족 운동.
자치론: 일제의 식민 지배를 인정하고 일제의 허용 범위 내에서 자치권을 얻자는 주장.
신간회: 타협적 민족주의자들이 자치론을 주장하자 비타협적 민족주의자들과 사회주의 계열이 연합하여 결성한 단체.; 전국 가지에서 강연회를 열고 일제의 식민 정책을 비판, 여러 농민, 노동 운동 등 사회 운동을 지원한 단체; 광주 학생 항일 운동에 진상 조사단을 파견한 단체.; 탄압과 활동 방향을 둘러싼 내분으로 1930년대 초 해소된 단체.
근우회: 신간회의 결성에 영향을 받아 결성된 여성 단체.
의열단: 김원봉 등이 만주 지린 성에서 조직한 단체로 김익상, 김상옥, 나석주 등이 참여하였다.; 김익상, 김상옥, 나석주 등이 참여하여 조선 총독부, 동양 척식 주식회사, 종로 경찰서, 식산 은행 등 식민 통치 기관을 파괴한 단체.; 1920년대 중반 조직적인 무장 투쟁을 위해 단원들이 군관 학교에 입학하여 교육을 받은 단체
김익상 | 김상옥 | 나석주: 조선 총독부에 폭탄 투척한 사람 | 종로 경찰서에 폭탄 투척한 사람 | 동양 척식 주식회사, 식산 은행에 폭탄 투척한 사람

봉오동 전투: 일제가 만주의 봉오동을 습격하자 홍범도가 이끄는 대한 독립군을 비롯한 독립군 연합 부대가 일본군을 격퇴한 전투.

청산리 대첩: 봉오동 전투 패한 일제가 만주의 독립군 소탕을 목적으로 공격한 사건.; 김좌진이 이끄는 북로 군정서군과 대한 독립군 등이 청산리 일대에서 일본군을 격퇴한 사건.

홍범도: 대한 독립군을 이끄는 사람으로 봉오동 전투에서 활약하였다.
김좌진: 북로 군정서군을 이끄는 사람으로 청산리 대첩에서 활약하였다.
간도 참변: 봉오동 전투, 청산리 대첩에서 참패한 일제가 간도 지역의 한인 마을을 불사르고 학살한 사건.
자유시 참변: 독립군이 밀산에 집결, 러시아 자유시로 이동했는데 독립군 내 지휘권 분쟁 중 독립군 해산을 요구한 러시아 적군(혁명군)이 해산을 요구하며 공격한 사건.
참의부 | 정의부 | 신민부: 자유시 참변 이후 만주로 돌아와 조직한 3부 (3개)
혁신 의회 | 국민부 : 자유시 참변 이후 생긴 3부를 통합하자는 의견에서 재편된 북만주의 이것과 남만주의 이것 (2개)
한국 독립군 | 조선 혁명군: 혁신 의회와 국민부 이후 조직된 2개의 무장 투쟁 조직 (2개)

##@ 세계사
제1차아편전쟁; 1차 아편 전쟁; 아편 전쟁: 임칙서가 광저우에서 아편을 몰수하자 이를 빌미로 영국이 일으킨 전쟁.; 이 전쟁으로 난징 조약이 체결되었다.
난징 조약: 청이 제1차 아편 전쟁을 패하고 체결한 조약; 상하이 등 5개 항구 개항과 홍콩 할양, 치외 법권, 공행 제도 폐지, 관세를 영국과 공동 결정, 공행 제도 폐지를 내용으로 하는 조약.
제 2차 아편전쟁; 2차 아편 전쟁; 아편 전쟁: 애로호 사건을 빌미로 영국이 프랑스와 함께 청을 공격한 전쟁.; 이 전쟁에서 패배한 청은 톈진 조약과 베이징 조약을 체결하였다.; 러시아는 이 전쟁을 중재해 준 대가로 연해주를 얻었다.; 이 전쟁으로 톈진 조약과 베이징 조약을 체결, 외국 공사의 베이징 주재와 크리스토교 포교를 허용하였다.
톈진 조약 | 베이징 조약: 제2차 아편 전쟁으로 인해 청이 체결한 조약 2개. (2개); 크리스트교 포교 허용, 외국 공사의 베이징 주재, 10개 항구 개항 등을 내용으로 한 조약 2개. (2개) ### 톈진과 베이징은 좀 다르긴 한데 비슷하다고 하자
홍수전: 태평천국 운동의 주도자.
태평천국 운동; 태평천국: 멸만흥한, 토지 균등 분배, 남녀 평등, 신분제 폐지를 내세운 운동; 홍수전이 크리스트교의 영향을 받아 주도한 운동.; 지도층의 내부 분열과 의용군, 열강들의 공격으로 망한 운동.(국가)
양무운동: 증극번과 이홍장 등이 태평천국 운동 진압 과정에서 서양 기술의 우수성을 깨닫고 중체서용을 내세워 전개한 운동.; 증극번, 이홍장 등이 주도하여 군수 산업을 중심으로 각종 공장, 산업 시설이 설립된 운동.; 보수파가 장악하고 지방 관료가 산업 잘전을 주도하여 정책의 일관성이 부족하였으며, 청일 전쟁에서 패배하며 이 운동은 실패하였다.
중체서용: 양무운동의 기본 방향.; 중국의 제도는 유지하되 서양의 기술은 이용한다는 의미.

캉유웨이 | 량치차오: 위기를 극복하기 위해 일본의 메이지 유신처럼 중국에 입헌 군주제를 포함한 제도 개혁이 필요하다고 주장한 사람들 (2명); 변법 자강 운동이 중단 된 이후 해외에서 입헌 운동을 추진한 사람들. (2명)
캉유웨이: 변법자강 운동을 추진한 사람.
변법자강 운동: 상공업 육성과 근대 교육, 신식 군대 양성 등의 내용을 포함한 운동.; 서태후를 중심으로 한 보수파의 탑압으로 100일 만에 중단된 중국의 운동.
갑신정변: 변법자강이랑 비슷한 우리나라의 개혁 운동.
의화단: 부청멸양이라는 구호를 내걸고 선교사, 교회, 철도 등을 공격한 단체.; 청은 이 단체와 함께 열강에게 선전 포고를 하였다.
신축 조약: 의화단 운동으로 외국 군대의 베이징 ㄷ주둔 허용 및 막대한 배상금 지불을 내용으로 하는 조약.
삼민주의: 쑨원이 주장하던 것.; 만주족 왕조를 몰아내는 민족, 공화정을 수립하는 민권, 토지의 국유화를 실현하는 민생을 일컫는 것.
중국 동맹회: 쑨원이 여러 혁명 단체를 모아 결성한 것.
쑨원: 중국 동맹회를 결성하고, 삼민주의를 주장하는 사람.; 신해혁명 이후 혁명파는 이 사람을 중화민국의 임시 대총통으로 세웠다.
신해혁명: 신사층과 민중이 만든 민간 철도를 국유화 하려 하자 혁명파가 무장 봉기를 일으키고 여러 성이 호응하여 독립을 선언한 사건.
중화민국: 신해혁명 이후 혁명파가 쑨원을 임시 대총통으로 세우고 수립을 선언한 국가.
위안스카이: 청 왕조로부터 혁명 세력 진압을 위임받았지만 혁명파와 타협하여 청 황제를 퇴위시킨 사람.; 청을 멸망시킨 다음 총통직을 승계받은 사람.
화교: 중국인이 해외 이주가 허용되자 외국에서 돈을 벌어 고향에 송금하거나 투자하여 중국의 산업화에 기여하거나 개혁 운동, 혁명 활동을 지원하기도 한 사람들.

미.일 화친 조약; 미일 화친 조약 | 미.일 수호 통상 조약 ; 미일 수호 통상 조약 : 페리 함대가 일본에 개항을 요구하자 에도 막부가 미국과 체결하여 개항하고 최혜국 대우와 치외 법권을 인정한 조약 2개 (2개)
메이지 유신: 외국 상품 수입, 물가 상승으로 경제가 악화되자 지방 무사 중심 막부 타도 운동으로 천황을 중심으로 한 새 정부가 들어서 본격적 개혁을 단행한 것.; 이 때 들어선 정부는 천황 중심 중앙 집권 국가를 만들기 위해 봉건제, 신분 차별 폐지하고 서양 기술 도입, 조세제 개혁, 상공업 육성, 징병제 시행 등을 추진하였다.; 이 때 들어선 정부는 이와쿠라 사절단을 유럽과 미국에 파견하였다.
이와쿠라 사절단: 메이지 정부가 서양 상황 파악 및 불평등 조약을 고치기 위해 유럽, 미국에 파견한 것.
후쿠자와 유키치: 이 사람을 비롯한 일본 지식인들은 일본에 서양의 학문과 제도를 소개하여 근대화에 이바지했다.
일본 제국 헌법: 참정권과 국회 개설을 요구하는 자유 민권 운동을 메이지 정부는 탄압하고 천황에게 절대적 권력이 주어지는 이 것을 제정하였다.

류큐; 오키나와: 일본이 가장 먼저 점령(침략)한 국가.
운요호 사건: 일본이 이 사건을 일으켜 조선에 강화도 조약을 체결하고 치외 법권을 인정하고과 부산 등 3개 항구를 개항하였다.
강화도 조약: 일본이 조선에 운요호 사건을 구실로 체결한 조약.
시모노세키 조약: 청일 전쟁에서 승리하고 청과 체결한 조약.; 이 조약으로 일본은 랴오둥반도와 타이완을 얻었지만 삼국 간섭으로 랴오둥반도를 청에 다시 반환했다.
랴오둥 반도; 요동 반도: 일본은 시모노세키 조약으로 타이완과 함께 이곳을 얻었지만 삼국 간섭으로 다시 청에 반환했다.
야하타 제철소: 청일 전쟁 이후 국가 주도 중공업 정책 실시로 세워진 것.
### 청일 전쟁 배상금으로 군비 증강
러시아; 러시아 제국: 일본이 영국과 동맹을 체결하고 미국의 지지를 바탕으로 공격한 나라.
포츠머스 조약: 일본이 러일 전쟁에서 승리하고 맺은 조약.; 일본이 이 조약으로 한국을 지도.보호할 권리가 있음을 확인받고 랴오둥 반도를 넘겨받았다.
을사조약; 을사늑약: 일본이 한국에 강압적으로 체결하여 한국을 보호국화 시킨 조약

플라시 전투: 영국이 프랑스와 벵골을 물리치고 인도 무역을 독점할 수 있게한 전투.
세포이의 항쟁; 세포이 항쟁; 세포이 반란; 세포이의 반란: 최초로 인도 각계각층이 광범위하게 참여한 민족 운동으로 내부 분열과 영국군의 반격으로 실패하였다.; 이 사건을 계기로 무굴제국이 멸망하고 인도 제국이 수립되었다.
인도 제국: 영국이 무굴 제국을 무너뜨리고 영국 왕이 인도 황제를 겸하는 국가.
인도 국민 회의: 인도 지식계층의 계몽 활동, 민족의식 성장으로 영국의 지원을 받아 창립된 것.; 초기에는 영국의 인도 지배를 인정하고 자치를 주장하였지만, 점차 영국의 지배 방식을 비판하고 인도인의 이익을 대변하는 단체로 발전하였다.
벵골 분할령: 영국이 인도의 민족 운동을 분열시키기 위해 벵골 지역을 종교에 따라 동서로 나눈 정책.; 이에 맞서 인도 국민 회의는 영국 제품 불매, 국산품 애용(스와데시), 자치 회득(스와라지), 민족 교육 실시를 요구하며 저항했다.; 인도 국민 회의의 저항이 거세지고 이슬람교도까지 참여한 민족 운동으로 발전하자 영국은 이것을 취소하고 명목상 인도 자치를 인정했다.

베트남 유신회: 판보이쩌우가 만든 베트남 조직으로 근대 문물을 수용하고 독립 정신을 키우기 위한 민족 운동을 전개했다.; 문맹 퇴치와 근대 사상 보급을 위해 통킹 의숙을 세운 단체.
시암: 왕실 중심으로 노예 해방, 부역 폐지, 철도 건설 등 근대 개혁을 실시하고 독립을 유지한 국가.
이슬람 동맹: 인도네시아에서 서양식 교육을 받은 지식인과 상인이 뭉쳐 결성한 것.
카르티니: 인도네시아에서 여성 교육을 위해 노력한 사람.
필리핀 연맹: 호세 리살이 조직한 단체로 계몽 운동을 벌였다.
호세 리살: 필리핀 연맹을 만든 사람.
아기날도: 호세 리살이 처형되자 비밀 결사를 조직하여 에스파냐에 맞서 싸우고 1898년 필리핀 독립을 선언한 사람.
### 이후 필리핀 미국 점령

탄지마트: 민족적, 종교적 파별을 없애고 세금, 교육 제도를 서구식으로 바꾸는 등의 변화를 시도한 개혁; 이런 개혁으로 의회가 설립되고 근대적 헌법이 제정되었지만 보수 세력의 반발과 유럽 열강의 개입 때문에 결과적으로 실패했다.
청년 튀르크당: 술탄 압둘 하미드 2세의 전제 정치 부활에 반발하여 청년 장교들이 반발하여 결성한 당.; 무력 혁명을 통해 권력을 잡고 헌법과 의회 부활과 근대 산업 육성, 외세 배척 운동을 전개했지만 극단적 튀르크 민족주의로 타민족이 반발하고 결국 1차 세계 대전에서 오스만 제국이 패하자 해체된 당.
술탄 압둘 하미드 2세; 압둘 하미드 2세: 러시아 튀르크 전쟁에서 오스만 제국이 패하자 전제 정치를 펼친 술탄
와하브 운동: 이븐 압둘 와하브가 주도한 초기 이슬람교 정신으로 돌아가자는 운동.; 오스만 제국이 아랍 지역을 지배하기 위해 내세운 술탄의 종교적 권위를 무너뜨리고 민족의식을 일깨우는데 기여한 운동.; 이 운동이 아라비아 반도에 전파되어 사우디아라비아 왕국이 건설되는 계기가 되었다.
아랍 문화 부흥 운동: 아랍 고전을 연구하는 운동으로 아랍 민족주의의 기반이 되고 현대 아랍어를 확립시키는 계기가 된 운동이다.
카자르 왕조: 18세기 말 이란을 통일한 왕조로 열강들의 이권 침탈에 재정 개혁 신식 학교 설립 등 근대적 개혁을 실시했지만 보수 세력의 반발 때문에 성과를 얻지 못하기도 했다.
입헌 혁명: 1906년 이란에 일어난 사건으로 의회 구성 및 입헌 군주제 헌법을 제정하였지만 영국, 러시아의 무력간섭으로 좌절되고 이란의 상당 부분이 두 나라에 의해 분할 점령됐다.

무함마드 알리: 오스만 제국의 이집트 총독으로 19세기 초 이집트 군대, 행정 기구, 교육 제도를 유럽식으로 바꾸고 산업을 육성하였고 결국 이집트는 오스만 제국으로부터 독립했다.
수에즈 운하: 이집트가 영국과 프랑스의 자금을 빌려 건설한 운하.; 이것을 건설 할 때 자금을 빌려서 결국 영국과 프랑스의 내정 간섭을 받게 된다.
아라비 파샤: '이집트는 이집트인에게'라는 구호를 내세운 외세 배격 운동을 주도한 사람.; 이 사람이 주도한 운동을 진압하고 1914년 영국은 이집트를 보호국으로 삼았다.
마흐디 운동; 구세주 운동: 수단에서 영국의 침략에 맞서 전개된 운동.
알제리: 30년간 프랑스에 맞서 싸운 아프리카 국가.
에티오피아: 라이베리아를 제외한 유럽 열강에 맞서 독립을 유지한 유일한 국가.
메넬리크 2세: 도로와 교량을 건설하고 서양의 근대적 교육 체제를 도입하고 최신 무기 수입, 유럽인 교관에게 군대 훈련을 맡겨 군사력을 강화하여 아도와 전투에서 이탈리아의 침략을 막아낸 사람.
